    ,---,.  
  ,'  .'  \ 
,---.' .' | 
|   |  |: | 
:   :  :  / 
:   |    ;  
|   :     \ 
|   |   . | 
'   :  '; | 
|   |  | ;  
|   :   /   
|   | ,'    
`----'      