  ,----..        
 /   /   \       
|   :     :      
.   |  ;. /      
.   ; /--`       
;   | ;          
|   : |          
.   | '___       
'   ; : .'|      
'   | '/  :      
|   :    /       
 \   \ .'        
  `---`          