    ,---,        
  .'  .' `\      
,---.'     \     
|   |  .`\  |    
:   : |  '  |    
|   ' '  ;  :    
'   | ;  .  |    
|   | :  |  '    
'   : | /  ;     
|   | '` ,/      
;   :  .'        
|   ,.'          
'---'            