    ,---,.       
  ,'  .' |       
,---.'   |       
|   |   .'       
:   :  |-,       
:   |  ;/|       
|   :   .'       
|   |  |-,       
'   :  ;/|       
|   |    \       
|   :   .'       
|   | ,'         
`----'           