    ,---,.       
  ,'  .' |       
,---.'   |       
|   |   .'       
:   :  :         
:   |  |-,       
|   :  ;/|       
|   |   .'       
'   :  '         
|   |  |         
|   :  \         
|   | ,'         
`----'           