  ,----..        
 /   /   \       
|   :     :      
.   |  ;. /      
.   ; /--`       
;   | ;  __      
|   : |.' .'     
.   | '_.' :     
'   ; : \  |     
'   | '/  .'     
|   :    /       
 \   \ .'        
  `---` 	