	    ,--,     
      ,--.'|     
   ,--,  | :     
,---.'|  : '     
|   | : _' |     
:   : |.'  |     
|   ' '  ; :     
'   |  .'. |     
|   | :  | '     
'   : |  : ;     
|   | '  ,/      
;   : ;--'       
|   ,/           
'---'            