   ,---,      
,`--.' |      
|   :  :      
:   |  '      
|   :  |      
'   '  ;      
|   |  |      
'   :  ;      
|   |  '      
'   :  |      
;   |.'       
'---'         