
         ,---._  
       .-- -.' \ 
       |    |   :
       :    ;   |
       :        |
       |    :   :
       :         
       |    ;   |
   ___ l         
 /    /\    J   :
/  ../  `..-    ,
\    \         ; 
 \    \      ,'  
  "---....--'    