       ,--. 
   ,--/  /| 
,---,': / ' 
:   : '/ /  
|   '   ,   
'   |  /    
|   ;  ;    
:   '   \   
|   |    '  
'   : |.  \ 
|   | '_\.' 
'   : |     
;   |,'     
'---'      	