          ____   
        ,'  , `. 
     ,-+-,.' _ | 
  ,-+-. ;   , || 
 ,--.'|'   |  ;| 
|   |  ,', |  ': 
|   | /  | |  || 
'   | :  | :  |, 
;   . |  ; |--'  
|   : |  | ,     
|   : '  |/      
;   | |`-'       
|   ;/           
'---'            