    ,----..    
   /   /   \   
  /   .     :  
 .   /   ;.  \ 
.   ;   /  ` ; 
;   |  ; \ ; | 
|   :  | ; | ' 
.   |  ' ' ' : 
'   ;  \; /  | 
 \   \  ',  /  
  ;   :    /   
   \   \ .'    
    `---`      