    ,----..      
   /   /   \     
  /   .     :    
 .   /   ;.  \   
.   ;   /  ` ;   
;   |  ; \ ; |   
|   :  | ; | '   
.   |  ' ' ' :   
'   ;  \; /  |   
 \   \  ',  . \  
  ;   :      ; | 
   \   \ .'`--"  
    `---`        