,-.----.    
\    /  \   
;   :    \  
|   | .\ :  
.   : |: |  
|   |  \ :  
|   : .  /  
;   | |  \  
|   | ;\  \ 
:   ' | \.' 
:   : :-'   
|   |.'     
`---'       