  .--.--.    
 /  /    '.  
|  :  /`. /  
;  |  |--`   
|  :  ;_     
 \  \    `.  
  `----.   \ 
  __ \  \  | 
 /  /`--'  / 
'--'.     /  
  `--'---'   