        ,----, 
      ,/   .`| 
    ,`   .'  : 
  ;    ;     / 
.'___,/    ,'  
|    :     |   
;    |.';  ;   
`----'  |  |   
    '   :  ;   
    |   |  '   
    '   :  |   
    ;   |.'    
    '---'      