
         ,--,  
       ,'_ /|  
  .--. |  | :  
,'_ /| :  . |  
|  ' | |  . .  
|  | ' |  | |  
:  | | :  ' ;  
|  ; ' |  | '  
:  | : ;  ; |  
'  :  `--'   \ 
:  ,      .-./ 
 `--`----'     