       ,---. 
      /__./| 
 ,---.;  ; | 
/___/ \  | | 
\   ;  \ ' | 
 \   \  \: | 
  ;   \  ' . 
   \   \   ' 
    \   `  ; 
     :   \ | 
      '---"  