           .---. 
          /. ./| 
      .--'.  ' ; 
     /__./ \ : | 
 .--'.  '   \' . 
/___/ \ |    ' ' 
;   \  \;      : 
 \   ;  `      | 
  .   \    .\  ; 
   \   \   ' \ | 
    :   '  |--"  
     \   \ ;     
      '---"      