 ,--,     ,--,  
 |'. \   / .`|  
 ; \ `\ /' / ;  
 `. \  /  / .'  
  \  \/  / ./   
   \  \.'  /    
    \  ;  ;     
   / \  \  \    
  ;  /\  \  \   
./__;  \  ;  \  
|   : / \  \  ; 
;   |/   \  ' | 
`---'     `--`  