         ,----, 
       .'   .`| 
    .'   .'   ; 
  ,---, '    .' 
  |   :     ./  
  ;   | .'  /   
  `---' /  ;    
    /  ;  /     
   ;  /  /--,   
  /  /  / .`|   
./__;       :   
|   :     .'    
;   |  .'       
`---'           