 888888ba  
 88    `8b 
a88aaaa8P' 
 88   `8b. 
 88    .88 
 88888888P 